8
5
F-------
-M--R---
--------
--------
--------